Bwana Nipe Pesa - Msanii Mtunzi
Nakei Nairobi - Mbilia Bel
So Sick - Ne-Yo
Jailer - Asa
Dunia Tuna Pita - Samba Mapangala
Suzanna - Sauti Sol
Heaven Sent - Keyshia Cole
Vulindéla - Caraibes Zouk Folies
Emlanjeni - Mafikizolo
If Love Is a Crime - 2Baba
Lonely - Akon
See You Again - Wiz Khalifa
Airplanes - B.o.B
No Air - Jordin Sparks & Chris Brown
Get Up - 50 Cent
Beautiful Girls - Sean Kingston
No One - Alicia Keys
Ayo Technology - 50 Cent
Chiquitita - ABBA
Rivers of Babylon - Boney M.
Kebs - Nyashinski
Ya laiti - Bi kidudé
Irreplaceable - Beyoncé
Free Soul - Grace Matata
Moyo Mashine - Ben Pol
Pon de Replay - Rihanna
Kiss Me Thru the Phone - Soulja Boy Tell 'Em
Lucille - Kenny Rogers
Johnny - Yemi Alade
Love Is Wicked - Brick & Lace
Fresh (Remix) - Fid Q
Ridin' - Chamillionaire
Stan - Eminem
Live Your Life - T.I.
Crazy in Love - Beyoncé
Survivor - Destiny's Child
Bleeding Love - Leona Lewis
Banjuka - DNA
Bad Boy - Amani
Nimekubali - Mez B
Ndi Ndi Ndi - Lady Jaydee
Nusu Nusu - Joh Makini
Katika - Navy Kenzo
Sweetest Girl - Niia, Akon, Wyclef Jean & Lil Wayne
Say Something - Justin Timberlake
Genie in a Bottle - Christina Aguilera
Wrecking Ball - Miley Cyrus
Sweet Home Alabama - Lynyrd Skynyrd
Into You - Tamia
Ever Blazin' - Sean Paul
Church Heathen - Shaggy
Sangoma - Yvonne Chaka Chaka
Umqombothi - Yvonne Chaka Chaka
Hunifahamu - Dully Sykes
All the Above - Maino
My Heart Will Go On - James Horner & Céline Dion
Hello - Lionel Richie
Set Fire to the Rain - Adele
Good Kisser - Usher
Lovin' You - Minnie Riperton
Knock You Down - Keri Hilson
Waterfalls - TLC
Footprints - T.O.K.
Where Is the Love? - Black Eyed Peas
Endless Love - Lionel Richie
I Will Always Love You - Whitney Houston
Human Nature - Michael Jackson
Takin' Back My Love - Enrique Iglesias
Touch My Body - Mariah Carey
Shape of You - Ed Sheeran
I Knew You Were Trouble - Taylor Swift
Like a Boy - Ciara
I Swear - All-4-One
End of the Road - Boyz II Men
Baby - Justin Bieber
Piano Man - Brandy
The Lazy Song - Bruno Mars
I Believe In You (Single Version) - Don Williams
Trumpets - Jason Derulo
Always On Time - Ja Rule